1 1 1 1 1 1 1 2 1 1 1 1 1 1 3 3 3 3 3 3 3 4 4 4 4 5 5 5 6 6 6 6 7 7 7 7 7 7 7 8 8 8 9 10 10 10 10 10 10 11 11 11 11 12 12 12 12 12 12 12 13 13 13 13 13 13 13 14 14 14 15 15 15 15 15 15 15 15 15 15 15 15 15 15 16 16 16 16 17 17 17 17 17 17 18 18 18 18
1 1 1 1 1 1 2 2 2 1 1 1 1 1 3 3 3 3 3 3 3 4 4 4 4 5 5 5 6 6 6 6 7 7 7 7 7 7 7 8 8 8 9 9 10 10 10 10 10 11 11 11 11 11 12 12 12 12 12 13 13 13 13 13 13 13 14 14 14 14 15 15 15 15 15 15 15 15 15 17 17 17 17 17 17 17 17 17 17 17 17 17 17 17 17 17 17 17
1 1 1 1 1 2 2 2 2 2 1 1 1 1 3 3 3 3 3 3 3 4 4 4 4 5 5 5 5 5 6 6 6 6 7 7 8 8 8 8 8 8 9 9 9 10 10 10 10 11 11 11 11 11 11 11 12 12 13 13 13 13 13 13 13 14 14 14 14 14 15 15 15 15 15 15 15 15 15 15 15 15 15 15 17 17 17 17 17 17 17 17 17 17 17 17 17 17
1 1 1 1 2 2 2 2 2 2 2 1 1 1 3 3 3 3 3 3 3 4 4 4 4 4 4 4 5 5 6 6 6 6 7 7 8 8 8 8 8 8 9 9 9 9 10 10 10 11 11 11 11 11 11 11 12 13 13 13 13 13 13 13 14 14 14 14 14 14 15 15 15 15 15 15 15 15 15 15 15 15 15 15 2 2 2 2 17 17 17 17 17 17 18 18 18 18 17
8 8 8 5 5 5 4 4 4 6 6 6 7 7 7 2 2 2 1 1 1 18 18 18 3 3 3 17 17 17 11 11 11 12 12 12 14 14 14 16 16 16 4 4 4 15 15 15 13 13 13 7 7 7 8 8 8 1 1 1 5 5 5 2 2 2 3 3 3 18 18 18 4 4 4 7 7 7 5 5 5 8 8 8 11 11 11 6 6 6 12 12 12 10 10 10 13 13
8 8 8 5 5 5 4 4 4 6 6 6 7 7 7 2 2 2 1 1 1 18 18 18 3 3 3 17 17 17 11 11 11 12 12 12 14 14 14 16 16 16 4 4 4 15 15 15 13 13 13 7 7 7 8 8 8 1 1 1 5 5 5 2 2 2 3 3 3 18 18 18 4 4 4 7 7 7 5 5 5 8 8 8 11 11 11 6 6 6 12 12 12 10 10 10 13 13
8 8 8 5 5 5 4 4 4 6 6 6 7 7 7 2 2 2 1 1 1 18 18 18 3 3 3 17 17 17 11 11 11 12 12 12 14 14 14 16 16 16 4 4 4 15 15 15 13 13 13 7 7 7 8 8 8 1 1 1 5 5 5 2 2 2 3 3 3 18 18 18 4 4 4 7 7 7 5 5 5 8 8 8 11 11 11 6 6 6 12 12 12 10 10 10 13 13
2 2 13 13 13 13 1 2 2 2 2 2 2 4 4 4 4 4 4 7 7 7 7 6 6 6 6 5 5 12 12 12 1 1 1 1 18 18 18 18 3 3 3 3 11 11 11 14 14 14 14 14 14 15 15 15 16 16 16 2 13 13 13 13 8 8 8 8 8 8 8 8 2 2 2 2 2 10 2 2 2 2 2 7 7 7 6 6 6 6 6 6 3 4 4 4 4 4
2 2 13 13 13 13 1 1 2 2 2 2 1 4 4 4 4 4 7 7 7 7 7 7 6 6 6 5 5 12 12 12 1 1 1 18 18 18 18 17 17 3 3 3 3 11 11 14 14 14 14 14 14 15 15 15 16 16 16 2 2 2 13 13 13 8 8 10 10 10 8 8 2 2 2 2 10 10 10 2 2 2 2 7 7 7 6 6 6 6 6 6 3 3 4 4 4 4
2 2 2 2 3 3 1 1 1 2 2 1 1 5 5 4 4 7 7 7 7 7 7 7 7 6 6 2 2 12 12 12 6 6 18 18 18 18 17 17 17 17 3 3 3 3 11 12 12 12 12 12 12 15 15 15 16 16 16 2 2 2 13 13 13 8 8 10 10 10 8 8 2 2 2 10 10 10 10 10 2 2 2 6 6 6 7 7 7 7 7 7 3 3 3 4 4 4
2 2 2 2 3 3 1 1 1 1 1 1 1 5 5 5 5 5 7 7 7 7 7 7 1 1 6 6 2 12 12 12 6 18 18 18 18 17 17 17 17 17 17 3 3 3 3 12 12 12 12 12 12 16 16 16 16 16 16 2 13 13 13 13 13 8 8 10 10 10 8 8 2 2 10 10 10 10 10 10 10 2 2 6 6 6 7 7 7 7 7 7 3 3 3 3 4 4
5 5 8 8 8 11 11 11 6 6 6 12 12 12 10 10 10 13 13 7 7 7 7 8 8 8 5 5 5 4 4 4 6 6 6 7 7 7 2 2 2 1 1 1 18 18 18 3 3 3 17 17 17 11 11 11 12 12 12 14 14 14 16 16 16 4 4 4 15 15 15 13 13 13 7 7 7 8 8 8 1 1 1 5 5 5 2 2 2 3 3 3 18 18 18 4 4 4
5 5 8 8 8 11 11 11 6 6 6 12 12 12 10 10 10 13 13 7 7 7 7 8 8 8 5 5 5 4 4 4 6 6 6 7 7 7 2 2 2 1 1 1 18 18 18 3 3 3 17 17 17 11 11 11 12 12 12 14 14 14 16 16 16 4 4 4 15 15 15 13 13 13 7 7 7 8 8 8 1 1 1 5 5 5 2 2 2 3 3 3 18 18 18 4 4 4
5 5 8 8 8 11 11 11 6 6 6 12 12 12 10 10 10 13 13 8 8 8 5 8 8 8 5 5 5 4 4 4 6 6 6 7 7 7 2 2 2 1 1 1 18 18 18 3 3 3 17 17 17 11 11 11 12 12 12 14 14 14 16 16 16 4 4 4 15 15 15 13 13 13 7 7 7 8 8 8 1 1 1 5 5 5 2 2 2 3 3 3 18 18 18 4 4 4
1 1 1 1 1 1 1 2 1 1 1 1 1 1 3 3 3 3 3 3 3 4 4 4 4 5 5 5 6 6 6 6 7 7 7 7 7 7 7 8 8 8 9 10 10 10 10 10 10 11 11 11 11 12 12 12 12 12 12 12 13 13 13 13 13 13 13 14 14 14 15 15 15 15 15 15 15 15 15 15 15 15 15 15 16 16 16 16 17 17 17 17 17 17 18 18 18 18
1 1 1 1 1 1 2 2 2 1 1 1 1 1 3 3 3 3 3 3 3 4 4 4 4 5 5 5 6 6 6 6 7 7 7 7 7 7 7 8 8 8 9 9 10 10 10 10 10 11 11 11 11 11 12 12 12 12 12 13 13 13 13 13 13 13 14 14 14 14 15 15 15 15 15 15 15 15 15 17 17 17 17 17 17 17 17 17 17 17 17 17 17 17 17 17 17 17
1 1 1 1 1 2 2 2 2 2 1 1 1 1 3 3 3 3 3 3 3 4 4 4 4 5 5 5 5 5 6 6 6 6 7 7 8 8 8 8 8 8 9 9 9 10 10 10 10 11 11 11 11 11 11 11 12 12 13 13 13 13 13 13 13 14 14 14 14 14 15 15 15 15 15 15 15 15 15 15 15 15 15 15 17 17 17 17 17 17 17 17 17 17 17 17 17 17
1 1 1 1 2 2 2 2 2 2 2 1 1 1 3 3 3 3 3 3 3 4 4 4 4 4 4 4 5 5 6 6 6 6 7 7 8 8 8 8 8 8 9 9 9 9 10 10 10 11 11 11 11 11 11 11 12 13 13 13 13 13 13 13 14 14 14 14 14 14 15 15 15 15 15 15 15 15 15 15 15 15 15 15 2 2 2 2 17 17 17 17 17 17 18 18 18 18 17
8 8 8 5 5 5 4 4 4 6 6 6 7 7 7 2 2 2 1 1 1 18 18 18 3 3 3 17 17 17 11 11 11 12 12 12 14 14 14 16 16 16 4 4 4 15 15 15 13 13 13 7 7 7 8 8 8 1 1 1 5 5 5 2 2 2 3 3 3 18 18 18 4 4 4 7 7 7 5 5 5 8 8 8 11 11 11 6 6 6 12 12 12 10 10 10 13 13
8 8 8 5 5 5 4 4 4 6 6 6 7 7 7 2 2 2 1 1 1 18 18 18 3 3 3 17 17 17 11 11 11 12 12 12 14 14 14 16 16 16 4 4 4 15 15 15 13 13 13 7 7 7 8 8 8 1 1 1 5 5 5 2 2 2 3 3 3 18 18 18 4 4 4 7 7 7 5 5 5 8 8 8 11 11 11 6 6 6 12 12 12 10 10 10 13 13
8 8 8 5 5 5 4 4 4 6 6 6 7 7 7 2 2 2 1 1 1 18 18 18 3 3 3 17 17 17 11 11 11 12 12 12 14 14 14 16 16 16 4 4 4 15 15 15 13 13 13 7 7 7 8 8 8 1 1 1 5 5 5 2 2 2 3 3 3 18 18 18 4 4 4 7 7 7 5 5 5 8 8 8 11 11 11 6 6 6 12 12 12 10 10 10 13 13
2 2 13 13 13 13 1 2 2 2 2 2 2 4 4 4 4 4 4 7 7 7 7 6 6 6 6 5 5 12 12 12 1 1 1 1 18 18 18 18 3 3 3 3 11 11 11 14 14 14 14 14 14 15 15 15 16 16 16 2 13 13 13 13 8 8 8 8 8 8 8 8 2 2 2 2 2 10 2 2 2 2 2 7 7 7 6 6 6 6 6 6 3 4 4 4 4 4
2 2 13 13 13 13 1 1 2 2 2 2 1 4 4 4 4 4 7 7 7 7 7 7 6 6 6 5 5 12 12 12 1 1 1 18 18 18 18 17 17 3 3 3 3 11 11 14 14 14 14 14 14 15 15 15 16 16 16 2 2 2 13 13 13 8 8 10 10 10 8 8 2 2 2 2 10 10 10 2 2 2 2 7 7 7 6 6 6 6 6 6 3 3 4 4 4 4
2 2 2 2 3 3 1 1 1 2 2 1 1 5 5 4 4 7 7 7 7 7 7 7 7 6 6 2 2 12 12 12 6 6 18 18 18 18 17 17 17 17 3 3 3 3 11 12 12 12 12 12 12 15 15 15 16 16 16 2 2 2 13 13 13 8 8 10 10 10 8 8 2 2 2 10 10 10 10 10 2 2 2 6 6 6 7 7 7 7 7 7 3 3 3 4 4 4
2 2 2 2 3 3 1 1 1 1 1 1 1 5 5 5 5 5 7 7 7 7 7 7 1 1 6 6 2 12 12 12 6 18 18 18 18 17 17 17 17 17 17 3 3 3 3 12 12 12 12 12 12 16 16 16 16 16 16 2 13 13 13 13 13 8 8 10 10 10 8 8 2 2 10 10 10 10 10 10 10 2 2 6 6 6 7 7 7 7 7 7 3 3 3 3 4 4
5 5 8 8 8 11 11 11 6 6 6 12 12 12 10 10 10 13 13 7 7 7 7 8 8 8 5 5 5 4 4 4 6 6 6 7 7 7 2 2 2 1 1 1 18 18 18 3 3 3 17 17 17 11 11 11 12 12 12 14 14 14 16 16 16 4 4 4 15 15 15 13 13 13 7 7 7 8 8 8 1 1 1 5 5 5 2 2 2 3 3 3 18 18 18 4 4 4
5 5 8 8 8 11 11 11 6 6 6 12 12 12 10 10 10 13 13 7 7 7 7 8 8 8 5 5 5 4 4 4 6 6 6 7 7 7 2 2 2 1 1 1 18 18 18 3 3 3 17 17 17 11 11 11 12 12 12 14 14 14 16 16 16 4 4 4 15 15 15 13 13 13 7 7 7 8 8 8 1 1 1 5 5 5 2 2 2 3 3 3 18 18 18 4 4 4
5 5 8 8 8 11 11 11 6 6 6 12 12 12 10 10 10 13 13 8 8 8 5 8 8 8 5 5 5 4 4 4 6 6 6 7 7 7 2 2 2 1 1 1 18 18 18 3 3 3 17 17 17 11 11 11 12 12 12 14 14 14 16 16 16 4 4 4 15 15 15 13 13 13 7 7 7 8 8 8 1 1 1 5 5 5 2 2 2 3 3 3 18 18 18 4 4 4
1 1 1 1 1 1 1 2 1 1 1 1 1 1 3 3 3 3 3 3 3 4 4 4 4 5 5 5 6 6 6 6 7 7 7 7 7 7 7 8 8 8 9 10 10 10 10 10 10 11 11 11 11 12 12 12 12 12 12 12 13 13 13 13 13 13 13 14 14 14 15 15 15 15 15 15 15 15 15 15 15 15 15 15 16 16 16 16 17 17 17 17 17 17 18 18 18 18
1 1 1 1 1 1 2 2 2 1 1 1 1 1 3 3 3 3 3 3 3 4 4 4 4 5 5 5 6 6 6 6 7 7 7 7 7 7 7 8 8 8 9 9 10 10 10 10 10 11 11 11 11 11 12 12 12 12 12 13 13 13 13 13 13 13 14 14 14 14 15 15 15 15 15 15 15 15 15 17 17 17 17 17 17 17 17 17 17 17 17 17 17 17 17 17 17 17
1 1 1 1 1 2 2 2 2 2 1 1 1 1 3 3 3 3 3 3 3 4 4 4 4 5 5 5 5 5 6 6 6 6 7 7 8 8 8 8 8 8 9 9 9 10 10 10 10 11 11 11 11 11 11 11 12 12 13 13 13 13 13 13 13 14 14 14 14 14 15 15 15 15 15 15 15 15 15 15 15 15 15 15 17 17 17 17 17 17 17 17 17 17 17 17 17 17
1 1 1 1 2 2 2 2 2 2 2 1 1 1 3 3 3 3 3 3 3 4 4 4 4 4 4 4 5 5 6 6 6 6 7 7 8 8 8 8 8 8 9 9 9 9 10 10 10 11 11 11 11 11 11 11 12 13 13 13 13 13 13 13 14 14 14 14 14 14 15 15 15 15 15 15 15 15 15 15 15 15 15 15 2 2 2 2 17 17 17 17 17 17 18 18 18 18 17
8 8 8 5 5 5 4 4 4 6 6 6 7 7 7 2 2 2 1 1 1 18 18 18 3 3 3 17 17 17 11 11 11 12 12 12 14 14 14 16 16 16 4 4 4 15 15 15 13 13 13 7 7 7 8 8 8 1 1 1 5 5 5 2 2 2 3 3 3 18 18 18 4 4 4 7 7 7 5 5 5 8 8 8 11 11 11 6 6 6 12 12 12 10 10 10 13 13
8 8 8 5 5 5 4 4 4 6 6 6 7 7 7 2 2 2 1 1 1 18 18 18 3 3 3 17 17 17 11 11 11 12 12 12 14 14 14 16 16 16 4 4 4 15 15 15 13 13 13 7 7 7 8 8 8 1 1 1 5 5 5 2 2 2 3 3 3 18 18 18 4 4 4 7 7 7 5 5 5 8 8 8 11 11 11 6 6 6 12 12 12 10 10 10 13 13
8 8 8 5 5 5 4 4 4 6 6 6 7 7 7 2 2 2 1 1 1 18 18 18 3 3 3 17 17 17 11 11 11 12 12 12 14 14 14 16 16 16 4 4 4 15 15 15 13 13 13 7 7 7 8 8 8 1 1 1 5 5 5 2 2 2 3 3 3 18 18 18 4 4 4 7 7 7 5 5 5 8 8 8 11 11 11 6 6 6 12 12 12 10 10 10 13 13
2 2 13 13 13 13 1 2 2 2 2 2 2 4 4 4 4 4 4 7 7 7 7 6 6 6 6 5 5 12 12 12 1 1 1 1 18 18 18 18 3 3 3 3 11 11 11 14 14 14 14 14 14 15 15 15 16 16 16 2 13 13 13 13 8 8 8 8 8 8 8 8 2 2 2 2 2 10 2 2 2 2 2 7 7 7 6 6 6 6 6 6 3 4 4 4 4 4
2 2 13 13 13 13 1 1 2 2 2 2 1 4 4 4 4 4 7 7 7 7 7 7 6 6 6 5 5 12 12 12 1 1 1 18 18 18 18 17 17 3 3 3 3 11 11 14 14 14 14 14 14 15 15 15 16 16 16 2 2 2 13 13 13 8 8 10 10 10 8 8 2 2 2 2 10 10 10 2 2 2 2 7 7 7 6 6 6 6 6 6 3 3 4 4 4 4
2 2 2 2 3 3 1 1 1 2 2 1 1 5 5 4 4 7 7 7 7 7 7 7 7 6 6 2 2 12 12 12 6 6 18 18 18 18 17 17 17 17 3 3 3 3 11 12 12 12 12 12 12 15 15 15 16 16 16 2 2 2 13 13 13 8 8 10 10 10 8 8 2 2 2 10 10 10 10 10 2 2 2 6 6 6 7 7 7 7 7 7 3 3 3 4 4 4
2 2 2 2 3 3 1 1 1 1 1 1 1 5 5 5 5 5 7 7 7 7 7 7 1 1 6 6 2 12 12 12 6 18 18 18 18 17 17 17 17 17 17 3 3 3 3 12 12 12 12 12 12 16 16 16 16 16 16 2 13 13 13 13 13 8 8 10 10 10 8 8 2 2 10 10 10 10 10 10 10 2 2 6 6 6 7 7 7 7 7 7 3 3 3 3 4 4
5 5 8 8 8 11 11 11 6 6 6 12 12 12 10 10 10 13 13 7 7 7 7 8 8 8 5 5 5 4 4 4 6 6 6 7 7 7 2 2 2 1 1 1 18 18 18 3 3 3 17 17 17 11 11 11 12 12 12 14 14 14 16 16 16 4 4 4 15 15 15 13 13 13 7 7 7 8 8 8 1 1 1 5 5 5 2 2 2 3 3 3 18 18 18 4 4 4
5 5 8 8 8 11 11 11 6 6 6 12 12 12 10 10 10 13 13 7 7 7 7 8 8 8 5 5 5 4 4 4 6 6 6 7 7 7 2 2 2 1 1 1 18 18 18 3 3 3 17 17 17 11 11 11 12 12 12 14 14 14 16 16 16 4 4 4 15 15 15 13 13 13 7 7 7 8 8 8 1 1 1 5 5 5 2 2 2 3 3 3 18 18 18 4 4 4
5 5 8 8 8 11 11 11 6 6 6 12 12 12 10 10 10 13 13 8 8 8 5 8 8 8 5 5 5 4 4 4 6 6 6 7 7 7 2 2 2 1 1 1 18 18 18 3 3 3 17 17 17 11 11 11 12 12 12 14 14 14 16 16 16 4 4 4 15 15 15 13 13 13 7 7 7 8 8 8 1 1 1 5 5 5 2 2 2 3 3 3 18 18 18 4 4 4
                                  
